------------------------------
-s**-----------------*******e-
---*-***-------------*--------
---***-*-----------***--------
-------*-----------*----------
-***-***-----------*----------
-*-***----***--*****----------
-*--------*-****--------------
-**********-------------------
------------------------------
------------------------------
------------------------------
------------------------------
------------------------------
------------------------------
------------------------------
------------------------------
------------------------------
------------------------------
------------------------------
------------------------------
------------------------------
------------------------------
------------------------------
------------------------------
------------------------------
------------------------------
------------------------------
------------------------------
------------------------------