------------------------------
-s***********************-**e-
----*---*-----*-----*---*-----
----*---*-----*-----*--**-----
----*---*-----*-----*--*------
----*---*-----*-----*--*------
----*----*-----*-----*-*------
-----*******************------
------------------------------
------------------------------
------------------------------
------------------------------
------------------------------
------------------------------
------------------------------
------------------------------
------------------------------
------------------------------
------------------------------
------------------------------
------------------------------
------------------------------
------------------------------
------------------------------
------------------------------
------------------------------
------------------------------
------------------------------
------------------------------
------------------------------