------------------------------
------------------------------  
------------------------------
------------------------------
-----*------------------------
-----*------------------------
-*****------------------------
-*----------------------------
-*----------------------------
-**---------------------------
--*---------------------------
--*---------------------------
--***-------------------------
----*-------------------------
----******--------------------
----*----------*--------------
----*----------*--------------
-s*******************---------
-----------*------------------
-----------*------------------
---------******---------------
---------*----******e---------
--------**--------------------
-------**---------------------
-------*----------------------
-------*----------------------
-------*----------------------
-----***----------------------
------------------------------
------------------------------
------------------------------