------------------------------
------------------------------  
------------------------------
------------------------------
-----*------------------------
-----*------------------------
-*****------------------------
-*----------------------------
-*----------------------------
-**---------------------------
--*---------------------------
--*---------------------------
--***-------------------------
----*-------------------------
----************--------------
----*----------*--------------
----*----------*--------------
-s*******************e--------
------------------------------
------------------------------
------------------------------
------------------------------
------------------------------
------------------------------
------------------------------
------------------------------
------------------------------
------------------------------
------------------------------
------------------------------
------------------------------