------------------------------
-****--****--------***---***--
-*--***-*-*******--*-**--*-*--
-*----*-*---*---*--*--*--*-*--
-*-***--*-*-**--*****----*-*--
-*-*-****-*--*------*----*-**-
-*-**-----******--*-******-*--
-*--******--*--**-*------*-*--
-****-*--*------***-****-*-*--
--------********-------*-*-*--
-s*--****------*-*--******-*--
--*-**--*-**-*-*-*---*-----*--
--***-*****--*-***---****--*--
----*-*-*-*--*---*---*--*--**-
-*--***-*-*-**-****--*--*---*-
-*------*-*--*-*---*----*-***-
-********-****-*-********---*-
-*--*---*----****---------*-*-
-*-**-*-******-------********-
-*----*-------********------*-
-******--***--*--------******-
---------*----********-*--*---
----****-****--------*-*--***-
-e***----*---*******-*-*----*-
---*--********-----*-*-****-*-
-***---*---*----****-*------*-
-*---***--*****--*-*-***-****-
-*****----*-----**-*---*---*--
-----****-*******--**********-
------------------------------