------------------------------
-**-****----****-*******---**-
-*-**--******--***--*--*****--
-*-*-***-*----**--*-**---****-
-*-*-*-*-****-*-**---****-*---
-****-**-**-****--***--*-****-
-**-***--**-*--****-****-*--*-
--*---*-**-*****-***-*-*-*-**-
-**-*-*-*-***-*-**--**-*-*-*--
-*-*-****----**-*****-*-****--
-e-*-*--******-**-*-*--**-*-*-
-*-****---******--****-*--*-*-
-*-*--*-***-***--*-*-*-*--*-*-
-*****-**-*-*--***-*-******-*-
-*----**-***-***-***-*--*-**--
-**-***--*-***-**--*-*-**--**-
---**-*-***--**-***-****-**-*-
-***---**-***-*-*-***--***--*-
-*-*****-*-*-*-****--*****--*-
-*-***--**-*-*-*-*-*s*-*-****-
-*-*-***---*-*-*-*-*---****---
-*-----*****---***-*--**--**--
-******---**-***----***--*-**-
-****-****--**-******-****--*-
-*---***-****-*--****---*****-
-*****-**-*****-*-*******-*---
---***--**-***--******---***--
-*-*-***-*--*--------*-**--*--
-*-***-****-***********-*****-
------------------------------
