------------------------------
--*******-*****-***-***-----*-
-**-----**-*--*-*-*-*-*******-
-*-****--*-*--*-*****-****-*--
-***---*****-***-*--******-**-
--*---**---*-*-***-**---**--*-
-**-***-***-***--*-*--*****-*-
-*--*-***-**--*--*-*--*---*-*-
-****---**-**-*-*****-**---**-
--*-***-----**-**-*-*---****--
--**--******-***--*******-**--
-*-***-***-***--*-*---*-*****-
-*-*-**----*--*-*****-*-**--*-
-****-******-*-**---*-*-*--**-
-*--****-*-*-*-s-****-******--
-**----*-*********-**--*--**--
--**---*--*--*---*****-*-****-
-*--*****-**-******--*-*----*-
-*-***--*--*-**-----**-***--*-
--**-****-**-*-******-**-**-*-
-**-***--**--*-*--*--**---***-
-*-**-****-*-*--***-**-***-*--
-*--*-*-*-*-*****-***-**-*--*-
-*--*****-***-*-**--***-*****-
-**-*--*-**--**--***--***-*-*-
--****-*e*--**-**--*-*-*-**-*-
-***-*-*--***-*-**-**-****--*-
-*-*****---*-***-**--**--****-
-***---*****-****-****-****---
------------------------------
