------------------------------
-**-*-*****-******-******-***-
--**--*-*-***--*-**-*-*-**--*-
-*-****-***---**--***-**-***--
--***--**--****-----**-*-*-**-
--*----*****-*******-*-*-*--*-
-**-****-*--***--*-*-*-****-*-
-*-**-**-****--*-*-*-*-*---**-
--**-****--*-*--**--********--
-**-----****-****-*-*-*-*-**--
-*-*****--****-*---****-****--
-*--**-******--*****--*--*-**-
-***-**-*-****-*-*-*-*****--*-
-*-**-*-**---**-**-*-*-**-*-*-
-**-****-***--***-**-*-*--***-
-*-*-*---*-***--*-*-****-**---
-*-*-****--*-*******---***-**-
-*-****-**s*-*-*-*-*-*-*--*-*-
-**---***-*-**-*-****--*--***-
--***--****---***---*****--*--
-**-***--*-****-******--**-**-
-e-**-**-***-*--***--***-**-*-
--**---*-*-*-*--*--***-**---*-
-**-****--****-***-*--*-*****-
---**-**-**-*-**--*****-*-*---
-***-*-******-*-**--*-***-***-
-*---*-*---*-***-****---**--*-
-****-****-***-**--*-***-**-*-
-**-***--***--*-****-****-***-
------------------------------
